map_cols=32
map_rows=24
tile_width=32
tile_height=32
tile_path=map\desert.png
tile_grid_id=1
barrier_layer_name=obstacle
<layer name=background>
30,30,30,30,30,30,30,30,30,30,30,30,30,30,30,30,30,30,30,30,30,30,30,30,30,30,30,30,30,30,30,30,
30,30,30,30,30,30,30,30,30,30,30,30,30,30,30,30,30,30,30,30,30,30,30,30,30,30,30,30,30,30,30,30,
30,30,30,30,30,30,30,30,30,30,30,30,30,30,30,30,30,30,30,30,30,30,30,30,30,30,30,30,30,30,30,30,
30,30,30,30,30,30,30,30,30,30,30,30,30,30,30,30,30,30,30,30,30,30,30,30,30,30,30,30,30,30,30,30,
30,30,30,30,30,30,30,30,30,30,30,30,30,30,30,30,30,30,30,30,30,30,30,30,30,30,30,30,30,30,30,30,
30,30,30,30,30,30,30,30,30,30,30,30,30,30,30,30,30,30,30,30,30,30,30,30,30,30,30,30,30,30,30,30,
30,30,30,30,30,30,30,30,30,30,30,30,30,30,30,30,30,30,30,30,30,30,30,30,30,30,30,30,30,30,30,30,
30,30,30,30,30,30,30,30,30,30,30,30,30,30,30,30,30,30,30,30,30,30,30,30,30,30,30,30,30,30,30,30,
30,30,30,30,30,30,30,30,30,30,30,30,30,30,30,30,30,30,30,30,30,30,30,30,30,30,30,30,30,30,30,30,
30,30,30,30,30,30,30,30,30,30,30,30,30,30,30,30,30,30,30,30,30,30,30,30,30,30,30,30,30,30,30,30,
30,30,30,30,30,30,30,30,30,30,30,30,30,30,30,30,30,30,30,30,30,30,30,30,30,30,30,30,30,30,30,30,
30,30,30,30,30,30,30,30,30,30,30,30,30,30,30,30,30,30,30,30,30,30,30,30,30,30,30,30,30,30,30,30,
30,30,30,30,30,30,30,30,30,30,30,30,30,30,30,30,30,30,30,30,30,30,30,30,30,30,30,30,30,30,30,30,
30,30,30,30,30,30,30,30,30,30,30,30,30,30,30,30,30,30,30,30,30,30,30,30,30,30,30,30,30,30,30,30,
30,30,30,30,30,30,30,30,30,30,30,30,30,30,30,30,30,30,30,30,30,30,30,30,30,30,30,30,30,30,30,30,
30,30,30,30,30,30,30,30,30,30,30,30,30,30,30,30,30,30,30,30,30,30,30,30,30,30,30,30,30,30,30,30,
30,30,30,30,30,30,30,30,30,30,30,30,30,30,30,30,30,30,30,30,30,30,30,30,30,30,30,30,30,30,30,30,
30,30,30,30,30,30,30,30,30,30,30,30,30,30,30,30,30,30,30,30,30,30,30,30,30,30,30,30,30,30,30,30,
30,30,30,30,30,30,30,30,30,30,30,30,30,30,30,30,30,30,30,30,30,30,30,30,30,30,30,30,30,30,30,30,
30,30,30,30,30,30,30,30,30,30,30,30,30,30,30,30,30,30,30,30,30,30,30,30,30,30,30,30,30,30,30,30,
30,30,30,30,30,30,30,30,30,30,30,30,30,30,30,30,30,30,30,30,30,30,30,30,30,30,30,30,30,30,30,30,
30,30,30,30,30,30,30,30,30,30,30,30,30,30,30,30,30,30,30,30,30,30,30,30,30,30,30,30,30,30,30,30,
30,30,30,30,30,30,30,30,30,30,30,30,30,30,30,30,30,30,30,30,30,30,30,30,30,30,30,30,30,30,30,30,
30,30,30,30,30,30,30,30,30,30,30,30,30,30,30,30,30,30,30,30,30,30,30,30,30,30,30,30,30,30,30,30
</layer>
<layer name=obstacle>
0,0,0,0,0,0,0,0,0,0,0,0,0,0,0,0,0,0,0,0,0,0,0,0,0,0,0,0,0,0,0,0,
0,0,0,0,0,0,0,0,0,0,0,0,0,0,0,0,0,0,0,0,0,0,0,0,0,0,0,0,0,0,0,0,
0,0,0,25,26,26,26,26,26,26,26,26,26,26,26,26,27,0,0,0,25,26,26,26,26,26,26,27,0,0,0,0,
0,0,0,41,42,37,36,37,34,36,42,42,42,42,42,42,43,0,0,0,41,42,42,42,42,42,42,43,0,0,0,0,
0,0,0,0,0,33,44,45,34,35,0,0,0,0,0,0,0,0,0,0,0,0,0,0,0,0,0,0,0,0,0,0,
0,0,0,0,0,33,34,36,37,35,0,0,0,0,0,0,0,0,0,0,0,0,0,0,0,0,0,0,0,0,0,0,
26,27,0,0,0,33,34,44,45,35,0,0,25,26,26,26,27,0,0,0,0,0,0,0,0,0,0,0,0,0,0,0,
37,35,0,0,0,33,36,37,34,35,0,0,33,36,37,34,35,0,0,0,25,26,26,26,26,27,0,0,0,0,25,26,
45,35,0,0,0,33,44,45,34,35,0,0,33,44,45,34,35,0,0,0,33,36,37,36,37,35,0,0,0,0,33,36,
37,35,0,0,0,41,42,42,42,43,0,0,41,42,42,42,43,0,0,0,33,44,45,44,45,35,0,0,0,0,33,44,
45,35,0,0,0,0,0,0,0,0,0,0,0,0,0,0,0,0,0,0,33,34,36,37,34,35,0,0,0,0,33,34,
37,35,0,0,0,0,0,0,0,0,0,0,0,0,0,0,0,0,0,0,33,34,44,45,34,35,0,0,0,0,33,36,
45,35,0,0,0,25,26,26,27,0,0,0,25,26,26,26,27,0,0,0,41,42,42,42,42,43,0,0,0,0,33,44,
34,35,0,0,0,33,34,34,35,0,0,0,33,34,36,37,35,0,0,0,0,0,0,0,0,0,0,0,0,0,33,34,
42,43,0,0,0,33,36,37,35,0,0,0,33,34,44,45,35,0,0,0,0,0,0,0,0,0,0,0,0,0,33,36,
0,0,0,0,0,33,44,45,35,0,0,0,33,34,34,34,35,0,0,0,25,26,26,26,26,27,0,0,0,0,33,44,
0,0,0,0,0,41,42,42,43,0,0,0,41,42,42,42,43,0,0,0,33,36,37,36,37,35,0,0,0,0,41,42,
0,0,0,0,0,0,0,0,0,0,0,0,0,0,0,0,0,0,0,0,33,44,45,44,45,35,0,0,0,0,0,0,
0,0,0,0,0,0,0,0,0,0,0,0,0,0,0,0,0,0,0,0,33,34,36,37,34,35,0,0,0,0,0,0,
0,0,0,25,26,26,27,0,0,0,25,26,26,26,26,26,26,26,26,26,45,34,44,45,34,44,26,26,27,0,0,0,
0,0,0,33,34,34,35,0,0,0,33,34,34,34,34,34,34,34,34,34,34,34,34,34,34,34,34,34,35,0,0,0,
0,0,0,41,42,42,43,0,0,0,41,42,42,42,42,42,42,42,42,42,42,42,42,42,42,42,42,42,43,0,0,0,
0,0,0,0,0,0,0,0,0,0,0,0,0,0,0,0,0,0,0,0,0,0,0,0,0,0,0,0,0,0,0,0,
0,0,0,0,0,0,0,0,0,0,0,0,0,0,0,0,0,0,0,0,0,0,0,0,0,0,0,0,0,0,0,0
</layer>